1111111111111111111
10000000E0000000001
1000000000000000001
1000000000000000001
1000000000000000001
1000000000000000001
1000000000000000001
10000P0000000000001
1000000000000000001
1111111111111111111
