1111111111111111111
10000000E0000000001
1000000000000000001
1000000000000000001
100C000000000C00001
1000  0000000000001
1000000000030000001
10000P0000000000001
10000000000000C0000
1111111111111111111
