1111111111111111111
1000000000000000001
1000000000000000001
1000000000000000001
100C000000000C00001
1000000000000000001
1000000000000000001
10000PE000000000001
10000000000000C0001
1111111111111111111
